1111111111111
10C10C00000C1
1000011C11001
1PC011E000001
1111111111111