11111111111111111111111111
10C10C000000000000000000C1
1000011C111111110111111001
1PC011E000C111CC000000C101
11111111111111111111111111